1 version Ether Titan
267 num components
1316 -4 -4 0 1
199 -4 -4 0 1
1313 -4 -3 0 1
201 -4 -3 0 1
1315 -4 -2 0 1
201 -4 -2 0 1
1313 -4 -1 0 1
201 -4 -1 0 1
1315 -4 0 0 1
201 -4 0 0 1
1314 -4 1 0 1
201 -4 1 0 1
1316 -4 2 0 1
201 -4 2 0 1
1316 -4 3 0 1
201 -4 3 0 1
1315 -4 4 0 1
201 -4 4 0 1
1314 -4 5 0 1
201 -4 5 0 1
1314 -4 6 0 1
199 -4 6 0 1
201 -4 7 0 1
1314 -3 -4 0 1
12788 -3 -3 0 1
1313 -3 -3 0 1
12791 -3 -2 0 1
1315 -3 -2 0 1
12790 -3 -1 0 1
1314 -3 -1 0 1
12790 -3 0 0 1
1313 -3 0 0 1
12788 -3 1 0 1
1313 -3 1 0 1
12791 -3 2 0 1
1315 -3 2 0 1
12788 -3 3 0 1
1314 -3 3 0 1
12789 -3 4 0 1
1316 -3 4 0 1
12789 -3 5 0 1
1313 -3 5 0 1
12789 -3 6 0 1
1316 -3 6 0 1
200 -3 6 0 1
1313 -2 -4 0 1
12789 -2 -3 0 1
1314 -2 -3 0 1
12790 -2 -2 0 1
1313 -2 -2 0 1
12789 -2 -1 0 1
1314 -2 -1 0 1
12790 -2 0 0 1
1314 -2 0 0 1
12790 -2 1 0 1
1314 -2 1 0 1
12791 -2 2 0 1
1316 -2 2 0 1
12790 -2 3 0 1
1315 -2 3 0 1
12789 -2 4 0 1
1316 -2 4 0 1
12789 -2 5 0 1
1315 -2 5 0 1
12791 -2 6 0 1
1314 -2 6 0 1
200 -2 6 0 1
1315 -1 -4 0 1
12788 -1 -3 0 1
1313 -1 -3 0 1
12788 -1 -2 0 1
1313 -1 -2 0 1
12788 -1 -1 0 1
1314 -1 -1 0 1
12790 -1 0 0 1
1314 -1 0 0 1
12791 -1 1 0 1
1313 -1 1 0 1
12789 -1 2 0 1
1313 -1 2 0 1
12790 -1 3 0 1
1316 -1 3 0 1
12788 -1 4 0 1
1316 -1 4 0 1
12788 -1 5 0 1
1315 -1 5 0 1
12790 -1 6 0 1
1316 -1 6 0 1
200 -1 6 0 1
1313 0 -4 0 1
12789 0 -3 0 1
1313 0 -3 0 1
12789 0 -2 0 1
1313 0 -2 0 1
12788 0 -1 0 1
1313 0 -1 0 1
12789 0 0 0 1
1316 0 0 0 1
12791 0 1 0 1
1313 0 1 0 1
12790 0 2 0 1
1316 0 2 0 1
12791 0 3 0 1
1316 0 3 0 1
12788 0 4 0 1
1314 0 4 0 1
12790 0 5 0 1
1316 0 5 0 1
12789 0 6 0 1
1313 0 6 0 1
200 0 6 0 1
1314 1 -4 0 1
12790 1 -3 0 1
1314 1 -3 0 1
12791 1 -2 0 1
1314 1 -2 0 1
12790 1 -1 0 1
1314 1 -1 0 1
12789 1 0 0 1
1314 1 0 0 1
12791 1 1 0 1
1316 1 1 0 1
12791 1 2 0 1
1315 1 2 0 1
12790 1 3 0 1
1315 1 3 0 1
12789 1 4 0 1
1315 1 4 0 1
12790 1 5 0 1
1314 1 5 0 1
12791 1 6 0 1
1315 1 6 0 1
200 1 6 0 1
1316 2 -4 0 1
12788 2 -3 0 1
1313 2 -3 0 1
12791 2 -2 0 1
1313 2 -2 0 1
12790 2 -1 0 1
1315 2 -1 0 1
12790 2 0 0 1
1316 2 0 0 1
12789 2 1 0 1
1316 2 1 0 1
12791 2 2 0 1
1316 2 2 0 1
12790 2 3 0 1
1314 2 3 0 1
12791 2 4 0 1
1314 2 4 0 1
12788 2 5 0 1
1316 2 5 0 1
12788 2 6 0 1
1314 2 6 0 1
200 2 6 0 1
1313 3 -4 0 1
12790 3 -3 0 1
1316 3 -3 0 1
12788 3 -2 0 1
1315 3 -2 0 1
12791 3 -1 0 1
1316 3 -1 0 1
12790 3 0 0 1
1316 3 0 0 1
12788 3 1 0 1
1315 3 1 0 1
12791 3 2 0 1
1316 3 2 0 1
12788 3 3 0 1
1316 3 3 0 1
12790 3 4 0 1
1313 3 4 0 1
12788 3 5 0 1
1316 3 5 0 1
12788 3 6 0 1
1313 3 6 0 1
200 3 6 0 1
1315 4 -4 0 1
12790 4 -3 0 1
1316 4 -3 0 1
12789 4 -2 0 1
1315 4 -2 0 1
12789 4 -1 0 1
1313 4 -1 0 1
12791 4 0 0 1
1313 4 0 0 1
12790 4 1 0 1
1314 4 1 0 1
12789 4 2 0 1
1315 4 2 0 1
12790 4 3 0 1
1315 4 3 0 1
12789 4 4 0 1
1315 4 4 0 1
12791 4 5 0 1
1314 4 5 0 1
12791 4 6 0 1
1313 4 6 0 1
200 4 6 0 1
1313 5 -4 0 1
12788 5 -3 0 1
1313 5 -3 0 1
12789 5 -2 0 1
1316 5 -2 0 1
12789 5 -1 0 1
1314 5 -1 0 1
12790 5 0 0 1
1316 5 0 0 1
12789 5 1 0 1
1315 5 1 0 1
12788 5 2 0 1
1315 5 2 0 1
12791 5 3 0 1
1314 5 3 0 1
12790 5 4 0 1
1313 5 4 0 1
12791 5 5 0 1
1313 5 5 0 1
12789 5 6 0 1
1314 5 6 0 1
200 5 6 0 1
1313 6 -4 0 1
201 6 -4 0 1
12788 6 -3 0 1
1315 6 -3 0 1
12788 6 -2 0 1
1315 6 -2 0 1
12789 6 -1 0 1
1313 6 -1 0 1
12789 6 0 0 1
1314 6 0 0 1
12789 6 1 0 1
1315 6 1 0 1
12790 6 2 0 1
1315 6 2 0 1
12791 6 3 0 1
1316 6 3 0 1
12789 6 4 0 1
1313 6 4 0 1
12788 6 5 0 1
1313 6 5 0 1
12791 6 6 0 1
1316 6 6 0 1
200 6 6 0 1
201 6 7 0 1
200 7 -4 0 1
12789 7 -3 0 1
1316 7 -3 0 1
12788 7 -2 0 1
1314 7 -2 0 1
12788 7 -1 0 1
1313 7 -1 0 1
12789 7 0 0 1
1314 7 0 0 1
12790 7 1 0 1
1315 7 1 0 1
12789 7 2 0 1
1316 7 2 0 1
12788 7 3 0 1
1315 7 3 0 1
12788 7 4 0 1
1315 7 4 0 1
12790 7 5 0 1
1316 7 5 0 1
12789 7 6 0 1
1316 7 6 0 1
200 7 6 0 1
