1 version Ether Titan
258 num components
1316 -5 -5 0 1
199 -5 -5 0 1
1313 -5 -4 0 1
1315 -5 -3 0 1
1313 -5 -2 0 1
1315 -5 -1 0 1
1314 -5 0 0 1
1316 -5 1 0 1
1316 -5 2 0 1
1315 -5 3 0 1
1314 -5 4 0 1
1314 -5 5 0 1
200 -5 5 0 1
201 -5 6 0 1
1314 -4 -5 0 1
12788 -4 -4 0 1
1313 -4 -4 0 1
12791 -4 -3 0 1
1315 -4 -3 0 1
12790 -4 -2 0 1
1314 -4 -2 0 1
12790 -4 -1 0 1
1313 -4 -1 0 1
12788 -4 0 0 1
1313 -4 0 0 1
12791 -4 1 0 1
1315 -4 1 0 1
12788 -4 2 0 1
1314 -4 2 0 1
12789 -4 3 0 1
1316 -4 3 0 1
12789 -4 4 0 1
1313 -4 4 0 1
12789 -4 5 0 1
1316 -4 5 0 1
12791 -4 6 0 1
1316 -4 6 0 1
1313 -3 -5 0 1
12789 -3 -4 0 1
1314 -3 -4 0 1
12790 -3 -3 0 1
1313 -3 -3 0 1
12789 -3 -2 0 1
1314 -3 -2 0 1
12790 -3 -1 0 1
1314 -3 -1 0 1
12790 -3 0 0 1
1314 -3 0 0 1
12791 -3 1 0 1
1316 -3 1 0 1
12790 -3 2 0 1
1315 -3 2 0 1
12789 -3 3 0 1
1316 -3 3 0 1
12789 -3 4 0 1
1315 -3 4 0 1
12791 -3 5 0 1
1314 -3 5 0 1
12788 -3 6 0 1
1313 -3 6 0 1
1315 -2 -5 0 1
12788 -2 -4 0 1
1313 -2 -4 0 1
12788 -2 -3 0 1
1313 -2 -3 0 1
12788 -2 -2 0 1
1314 -2 -2 0 1
12790 -2 -1 0 1
1314 -2 -1 0 1
12791 -2 0 0 1
1313 -2 0 0 1
12789 -2 1 0 1
1313 -2 1 0 1
12790 -2 2 0 1
1316 -2 2 0 1
12788 -2 3 0 1
1316 -2 3 0 1
12788 -2 4 0 1
1315 -2 4 0 1
12790 -2 5 0 1
1316 -2 5 0 1
12790 -2 6 0 1
1313 -2 6 0 1
1313 -1 -5 0 1
12789 -1 -4 0 1
1313 -1 -4 0 1
12789 -1 -3 0 1
1313 -1 -3 0 1
12788 -1 -2 0 1
1313 -1 -2 0 1
12789 -1 -1 0 1
1316 -1 -1 0 1
12791 -1 0 0 1
1313 -1 0 0 1
12790 -1 1 0 1
1316 -1 1 0 1
12791 -1 2 0 1
1316 -1 2 0 1
12788 -1 3 0 1
1314 -1 3 0 1
12790 -1 4 0 1
1316 -1 4 0 1
12789 -1 5 0 1
1313 -1 5 0 1
12789 -1 6 0 1
1313 -1 6 0 1
1314 0 -5 0 1
12790 0 -4 0 1
1314 0 -4 0 1
12791 0 -3 0 1
1314 0 -3 0 1
12790 0 -2 0 1
1314 0 -2 0 1
12789 0 -1 0 1
1314 0 -1 0 1
12791 0 0 0 1
1316 0 0 0 1
12791 0 1 0 1
1315 0 1 0 1
12790 0 2 0 1
1315 0 2 0 1
12789 0 3 0 1
1315 0 3 0 1
12790 0 4 0 1
1314 0 4 0 1
12791 0 5 0 1
1315 0 5 0 1
12789 0 6 0 1
1316 0 6 0 1
1316 1 -5 0 1
12788 1 -4 0 1
1313 1 -4 0 1
12791 1 -3 0 1
1313 1 -3 0 1
12790 1 -2 0 1
1315 1 -2 0 1
12790 1 -1 0 1
1316 1 -1 0 1
12789 1 0 0 1
1316 1 0 0 1
12791 1 1 0 1
1316 1 1 0 1
12790 1 2 0 1
1314 1 2 0 1
12791 1 3 0 1
1314 1 3 0 1
12788 1 4 0 1
1316 1 4 0 1
12788 1 5 0 1
1314 1 5 0 1
12789 1 6 0 1
1314 1 6 0 1
1313 2 -5 0 1
12790 2 -4 0 1
1316 2 -4 0 1
12788 2 -3 0 1
1315 2 -3 0 1
12791 2 -2 0 1
1316 2 -2 0 1
12790 2 -1 0 1
1316 2 -1 0 1
12788 2 0 0 1
1315 2 0 0 1
12791 2 1 0 1
1316 2 1 0 1
12788 2 2 0 1
1316 2 2 0 1
12790 2 3 0 1
1313 2 3 0 1
12788 2 4 0 1
1316 2 4 0 1
12788 2 5 0 1
1313 2 5 0 1
12791 2 6 0 1
1316 2 6 0 1
1315 3 -5 0 1
12790 3 -4 0 1
1316 3 -4 0 1
12789 3 -3 0 1
1315 3 -3 0 1
12789 3 -2 0 1
1313 3 -2 0 1
12791 3 -1 0 1
1313 3 -1 0 1
12790 3 0 0 1
1314 3 0 0 1
12789 3 1 0 1
1315 3 1 0 1
12790 3 2 0 1
1315 3 2 0 1
12789 3 3 0 1
1315 3 3 0 1
12791 3 4 0 1
1314 3 4 0 1
12791 3 5 0 1
1313 3 5 0 1
12791 3 6 0 1
1315 3 6 0 1
1313 4 -5 0 1
12788 4 -4 0 1
1313 4 -4 0 1
12789 4 -3 0 1
1316 4 -3 0 1
12789 4 -2 0 1
1314 4 -2 0 1
12790 4 -1 0 1
1316 4 -1 0 1
12789 4 0 0 1
1315 4 0 0 1
12788 4 1 0 1
1315 4 1 0 1
12791 4 2 0 1
1314 4 2 0 1
12790 4 3 0 1
1313 4 3 0 1
12791 4 4 0 1
1313 4 4 0 1
12789 4 5 0 1
1314 4 5 0 1
12789 4 6 0 1
1315 4 6 0 1
1313 5 -5 0 1
201 5 -5 0 1
12788 5 -4 0 1
1315 5 -4 0 1
201 5 -4 0 1
12788 5 -3 0 1
1315 5 -3 0 1
201 5 -3 0 1
12789 5 -2 0 1
1313 5 -2 0 1
201 5 -2 0 1
12789 5 -1 0 1
1314 5 -1 0 1
201 5 -1 0 1
12789 5 0 0 1
1315 5 0 0 1
201 5 0 0 1
12790 5 1 0 1
1315 5 1 0 1
201 5 1 0 1
12791 5 2 0 1
1316 5 2 0 1
201 5 2 0 1
12789 5 3 0 1
1313 5 3 0 1
201 5 3 0 1
12788 5 4 0 1
1313 5 4 0 1
201 5 4 0 1
12791 5 5 0 1
1316 5 5 0 1
201 5 5 0 1
12788 5 6 0 1
1313 5 6 0 1
201 5 6 0 1
200 6 -5 0 1
200 6 5 0 1
