1 version Ether Titan
278 num components
1316 0 0 0 1
199 0 0 0 1
1313 0 1 0 1
201 0 1 0 1
1315 0 2 0 1
201 0 2 0 1
1313 0 3 0 1
201 0 3 0 1
1315 0 4 0 1
201 0 4 0 1
1314 0 5 0 1
201 0 5 0 1
1316 0 6 0 1
201 0 6 0 1
1316 0 7 0 1
201 0 7 0 1
1315 0 8 0 1
201 0 8 0 1
1314 0 9 0 1
201 0 9 0 1
1314 0 10 0 1
199 0 10 0 1
201 0 11 0 1
1314 1 0 0 1
12788 1 1 0 1
1313 1 1 0 1
12791 1 2 0 1
1315 1 2 0 1
12790 1 3 0 1
1314 1 3 0 1
12790 1 4 0 1
1313 1 4 0 1
12788 1 5 0 1
1313 1 5 0 1
12791 1 6 0 1
1315 1 6 0 1
12788 1 7 0 1
1314 1 7 0 1
12789 1 8 0 1
1316 1 8 0 1
12789 1 9 0 1
1313 1 9 0 1
12789 1 10 0 1
1316 1 10 0 1
12791 1 11 0 1
1316 1 11 0 1
1313 2 0 0 1
12789 2 1 0 1
1314 2 1 0 1
12790 2 2 0 1
1313 2 2 0 1
12789 2 3 0 1
1314 2 3 0 1
12790 2 4 0 1
1314 2 4 0 1
12790 2 5 0 1
1314 2 5 0 1
12791 2 6 0 1
1316 2 6 0 1
12790 2 7 0 1
1315 2 7 0 1
12789 2 8 0 1
1316 2 8 0 1
12789 2 9 0 1
1315 2 9 0 1
12791 2 10 0 1
1314 2 10 0 1
12788 2 11 0 1
1313 2 11 0 1
1315 3 0 0 1
12788 3 1 0 1
1313 3 1 0 1
12788 3 2 0 1
1313 3 2 0 1
12788 3 3 0 1
1314 3 3 0 1
12790 3 4 0 1
1314 3 4 0 1
12791 3 5 0 1
1313 3 5 0 1
12789 3 6 0 1
1313 3 6 0 1
12790 3 7 0 1
1316 3 7 0 1
12788 3 8 0 1
1316 3 8 0 1
12788 3 9 0 1
1315 3 9 0 1
12790 3 10 0 1
1316 3 10 0 1
12790 3 11 0 1
1313 3 11 0 1
1313 4 0 0 1
12789 4 1 0 1
1313 4 1 0 1
12789 4 2 0 1
1313 4 2 0 1
12788 4 3 0 1
1313 4 3 0 1
12789 4 4 0 1
1316 4 4 0 1
12791 4 5 0 1
1313 4 5 0 1
12790 4 6 0 1
1316 4 6 0 1
12791 4 7 0 1
1316 4 7 0 1
12788 4 8 0 1
1314 4 8 0 1
12790 4 9 0 1
1316 4 9 0 1
12789 4 10 0 1
1313 4 10 0 1
12789 4 11 0 1
1313 4 11 0 1
1314 5 0 0 1
12790 5 1 0 1
1314 5 1 0 1
12791 5 2 0 1
1314 5 2 0 1
12790 5 3 0 1
1314 5 3 0 1
12789 5 4 0 1
1314 5 4 0 1
12791 5 5 0 1
1316 5 5 0 1
12791 5 6 0 1
1315 5 6 0 1
12790 5 7 0 1
1315 5 7 0 1
12789 5 8 0 1
1315 5 8 0 1
12790 5 9 0 1
1314 5 9 0 1
12791 5 10 0 1
1315 5 10 0 1
12789 5 11 0 1
1316 5 11 0 1
1316 6 0 0 1
12788 6 1 0 1
1313 6 1 0 1
12791 6 2 0 1
1313 6 2 0 1
12790 6 3 0 1
1315 6 3 0 1
12790 6 4 0 1
1316 6 4 0 1
12789 6 5 0 1
1316 6 5 0 1
12791 6 6 0 1
1316 6 6 0 1
12790 6 7 0 1
1314 6 7 0 1
12791 6 8 0 1
1314 6 8 0 1
12788 6 9 0 1
1316 6 9 0 1
12788 6 10 0 1
1314 6 10 0 1
12789 6 11 0 1
1314 6 11 0 1
1313 7 0 0 1
12790 7 1 0 1
1316 7 1 0 1
12788 7 2 0 1
1315 7 2 0 1
12791 7 3 0 1
1316 7 3 0 1
12790 7 4 0 1
1316 7 4 0 1
12788 7 5 0 1
1315 7 5 0 1
12791 7 6 0 1
1316 7 6 0 1
12788 7 7 0 1
1316 7 7 0 1
12790 7 8 0 1
1313 7 8 0 1
12788 7 9 0 1
1316 7 9 0 1
12788 7 10 0 1
1313 7 10 0 1
12791 7 11 0 1
1316 7 11 0 1
1315 8 0 0 1
12790 8 1 0 1
1316 8 1 0 1
12789 8 2 0 1
1315 8 2 0 1
12789 8 3 0 1
1313 8 3 0 1
12791 8 4 0 1
1313 8 4 0 1
12790 8 5 0 1
1314 8 5 0 1
12789 8 6 0 1
1315 8 6 0 1
12790 8 7 0 1
1315 8 7 0 1
12789 8 8 0 1
1315 8 8 0 1
12791 8 9 0 1
1314 8 9 0 1
12791 8 10 0 1
1313 8 10 0 1
12791 8 11 0 1
1315 8 11 0 1
1313 9 0 0 1
12788 9 1 0 1
1313 9 1 0 1
12789 9 2 0 1
1316 9 2 0 1
12789 9 3 0 1
1314 9 3 0 1
12790 9 4 0 1
1316 9 4 0 1
12789 9 5 0 1
1315 9 5 0 1
12788 9 6 0 1
1315 9 6 0 1
12791 9 7 0 1
1314 9 7 0 1
12790 9 8 0 1
1313 9 8 0 1
12791 9 9 0 1
1313 9 9 0 1
12789 9 10 0 1
1314 9 10 0 1
12789 9 11 0 1
1315 9 11 0 1
1313 10 0 0 1
201 10 0 0 1
12788 10 1 0 1
1315 10 1 0 1
12788 10 2 0 1
1315 10 2 0 1
12789 10 3 0 1
1313 10 3 0 1
12789 10 4 0 1
1314 10 4 0 1
12789 10 5 0 1
1315 10 5 0 1
12790 10 6 0 1
1315 10 6 0 1
12791 10 7 0 1
1316 10 7 0 1
12789 10 8 0 1
1313 10 8 0 1
12788 10 9 0 1
1313 10 9 0 1
12791 10 10 0 1
1316 10 10 0 1
204 10 10 0 1
12788 10 11 0 1
1313 10 11 0 1
201 10 11 0 1
200 11 0 0 1
12789 11 1 0 1
1316 11 1 0 1
12788 11 2 0 1
1314 11 2 0 1
12788 11 3 0 1
1313 11 3 0 1
12789 11 4 0 1
1314 11 4 0 1
12790 11 5 0 1
1315 11 5 0 1
12789 11 6 0 1
1316 11 6 0 1
12788 11 7 0 1
1315 11 7 0 1
12788 11 8 0 1
1315 11 8 0 1
12790 11 9 0 1
1316 11 9 0 1
12789 11 10 0 1
1316 11 10 0 1
200 11 10 0 1
